01,01,01,01,01,01,01,01,01,01,01,01,01,01,01,01,01,01,01,01,01,01,01,01,12,00,00,00,07,01
01,01,01,01,01,01,01,01,01,01,01,01,01,01,01,01,01,01,01,01,01,01,01,01,12,00,00,00,07,01
01,01,04,04,04,04,04,04,04,01,01,04,04,04,04,04,04,01,01,04,04,04,04,04,09,00,00,00,07,01
01,12,00,00,00,00,00,00,00,11,09,00,00,00,00,00,00,11,09,00,00,00,00,00,00,00,00,00,07,01
01,12,00,00,00,00,00,00,00,00,00,00,00,00,00,00,00,00,00,00,00,00,00,00,00,00,00,00,07,01
01,12,00,00,00,10,08,00,00,00,00,00,00,10,08,00,00,00,00,00,00,10,08,00,00,00,00,00,07,01
01,12,00,00,00,07,01,05,05,05,05,05,05,01,01,05,05,05,05,05,05,01,01,05,05,05,05,05,01,01
01,12,00,00,00,11,04,04,04,04,04,01,01,04,04,04,04,04,01,01,04,04,04,04,04,04,04,01,01,01
01,12,00,00,00,00,00,00,00,00,00,11,09,00,00,00,00,00,11,09,00,00,00,00,00,00,00,07,01,01
01,12,00,00,00,00,00,00,00,00,00,03,03,00,00,00,00,00,03,03,00,00,00,00,00,00,00,07,01,01
01,12,00,00,00,00,00,00,10,08,00,03,03,00,00,10,08,00,03,03,00,00,10,08,00,00,00,07,01,01
01,12,00,00,00,00,00,00,07,12,00,03,03,00,00,07,12,00,03,03,00,00,07,12,00,00,00,07,01,01
01,01,05,05,05,05,05,05,01,01,05,05,05,05,05,01,01,05,05,05,05,05,01,12,00,00,00,07,01,01
01,01,04,04,04,04,04,04,01,01,04,04,04,04,04,01,01,04,04,04,04,04,01,12,00,00,00,07,01,01
01,12,00,00,00,00,00,00,11,09,00,00,00,00,00,11,09,00,00,00,00,00,11,09,00,00,00,07,01,01
01,12,00,00,00,00,00,00,03,03,00,00,00,00,00,03,03,00,00,00,00,00,00,00,00,00,00,07,01,01
01,12,00,00,00,00,00,00,03,03,00,10,08,00,00,03,03,00,10,08,00,00,00,00,00,00,00,07,01,01
01,12,00,00,00,00,00,00,03,03,00,07,12,00,00,03,03,00,07,12,00,00,00,00,00,00,00,07,01,01
01,12,00,00,00,10,05,05,05,05,05,01,01,05,05,05,05,05,01,01,05,05,05,05,05,05,05,01,01,01

1,1,1,1,1,1,1,1,1,1,1,1,1,1,1,1,1,1,1,1,1,1,1,1,3,0,0,0,3,1
1,1,1,1,1,1,1,1,1,1,1,1,1,1,1,1,1,1,1,1,1,1,1,1,3,0,0,0,3,1
1,1,2,2,2,2,2,2,2,1,1,2,2,2,2,2,2,1,1,2,2,2,2,2,7,0,0,0,3,1
1,3,0,0,0,0,0,0,0,6,7,0,0,0,0,0,0,6,7,0,0,0,0,0,0,0,0,0,3,1
1,3,0,0,0,0,0,0,0,0,0,0,0,0,0,0,0,0,0,0,0,0,0,0,0,0,0,0,3,1
1,3,0,0,0,4,5,0,0,0,0,0,0,4,5,0,0,0,0,0,0,4,5,0,0,0,0,0,3,1
1,3,0,0,0,3,1,2,2,2,2,2,2,1,1,2,2,2,2,2,2,1,1,2,2,2,2,2,1,1
1,3,0,0,0,6,2,2,2,2,2,1,1,2,2,2,2,2,1,1,2,2,2,2,2,2,2,1,1,1
1,3,0,0,0,0,0,0,0,0,0,6,7,0,0,0,0,0,6,7,0,0,0,0,0,0,0,3,1,1
1,3,0,0,0,0,0,0,0,0,0,0,0,0,0,0,0,0,0,0,0,0,0,0,0,0,0,3,1,1
1,3,0,0,0,0,0,0,4,5,0,9,9,0,0,4,5,0,0,9,9,0,4,5,0,0,0,3,1,1
1,3,0,0,0,0,0,0,3,3,0,0,0,0,0,3,3,0,0,0,0,0,3,3,0,0,0,3,1,1
1,1,2,2,2,2,2,2,1,1,2,2,2,2,2,1,1,2,2,2,2,2,1,3,0,0,0,3,1,1
1,1,2,2,2,2,2,2,1,1,2,2,2,2,2,1,1,2,2,2,2,2,1,3,0,0,0,3,1,1
1,3,0,0,0,0,0,0,6,7,0,0,0,0,0,6,7,0,0,0,0,0,6,7,0,0,0,3,1,1
1,3,0,0,0,0,0,0,0,0,0,0,0,0,0,0,0,0,0,0,0,0,0,0,0,0,0,3,1,1
1,3,0,0,0,0,0,0,9,9,0,4,5,0,0,9,9,0,4,5,0,0,0,0,0,0,0,3,1,1
1,3,0,0,0,0,0,0,0,0,0,3,3,0,0,0,0,0,3,3,0,0,0,0,0,0,0,3,1,1
1,3,0,0,0,4,2,2,2,2,2,1,1,2,2,2,2,2,1,1,2,2,2,2,2,2,2,1,1,1