01,01,12,00,00,00,00,00,00,00,00,07,01,01,01,12,00,00,00,00,00,00,00,00,00,07,01,01,01,01
01,01,12,00,00,00,00,00,00,00,00,07,01,01,01,12,00,00,00,00,00,00,00,00,00,07,01,01,01,01
01,01,12,00,00,00,00,00,00,00,00,07,01,01,01,12,00,00,00,00,00,00,00,00,00,11,04,04,04,04
01,01,12,00,00,10,05,08,00,00,00,11,04,01,01,12,00,00,00,10,05,08,00,00,00,00,00,00,00,00
04,04,09,00,00,07,01,12,00,00,00,00,00,07,01,12,00,00,00,07,01,12,00,00,00,00,00,00,00,00
00,00,00,00,00,07,01,12,00,00,00,00,00,07,01,12,00,00,00,07,01,01,05,05,08,00,00,00,00,00
00,00,00,00,00,07,01,12,00,00,00,00,00,07,01,12,00,00,00,07,01,01,01,01,12,00,00,00,00,00
00,00,00,00,00,07,01,01,05,05,08,00,00,07,01,12,00,00,00,07,01,01,04,04,09,00,00,00,00,00
00,00,10,05,05,01,01,01,01,01,12,00,00,07,01,12,00,00,00,07,01,12,00,00,00,00,00,00,00,00
00,00,07,01,01,01,01,01,04,04,09,00,00,07,01,12,00,00,00,07,01,12,00,00,00,00,00,00,00,00
00,00,11,04,04,01,01,12,00,00,00,00,00,07,01,12,00,00,00,03,03,03,00,00,00,00,10,05,05,05
00,00,00,00,00,07,01,12,00,00,00,00,00,07,01,12,00,00,00,03,03,03,00,00,00,00,07,01,01,01
00,00,00,00,00,07,01,12,00,00,00,00,00,07,01,12,00,00,00,03,03,03,00,00,00,00,07,01,01,01
05,05,08,00,00,07,01,12,00,00,10,05,05,01,01,12,00,00,00,07,01,12,00,00,00,00,11,04,04,04
01,01,12,00,00,07,01,12,00,00,07,01,01,01,01,12,00,00,00,07,01,12,00,00,00,00,00,00,00,00
04,04,09,00,00,07,01,12,00,00,11,04,04,04,04,09,00,00,00,07,01,12,00,00,00,00,00,00,00,00
00,00,00,00,00,07,01,12,00,00,00,00,00,00,00,00,00,00,00,07,01,01,05,05,08,00,00,00,00,00
00,00,00,00,00,07,01,12,00,00,00,00,00,00,00,00,00,00,00,07,01,01,01,01,12,00,00,00,00,00
00,00,00,00,00,07,01,12,00,00,00,00,00,00,00,00,00,00,00,07,01,01,01,01,12,00,00,00,00,00

0,0,3,0,0,0,0,0,0,0,0,3,0,0,0,3,0,0,0,0,0,0,0,0,0,3,0,0,0,0
0,0,3,0,0,0,0,0,0,0,0,3,0,0,0,3,0,0,0,0,0,0,0,0,0,3,0,0,0,0
0,0,3,0,0,0,0,0,0,0,0,3,0,0,0,3,0,0,0,0,0,0,0,0,0,6,2,2,2,2
0,0,3,0,0,4,2,5,0,0,0,6,2,1,0,3,0,0,0,4,2,5,0,0,0,0,0,0,0,0
2,2,7,0,0,3,0,3,0,0,0,0,0,3,0,3,0,0,0,3,0,3,0,0,0,0,0,0,0,0
0,0,0,0,0,3,0,3,0,0,0,0,0,3,0,3,0,0,0,3,0,1,2,2,5,0,0,0,0,0
0,0,0,0,0,3,0,3,0,0,0,0,0,3,0,3,0,0,0,3,0,0,0,0,3,0,0,0,0,0
0,0,0,0,0,3,0,1,2,2,5,0,0,3,0,3,0,0,0,3,0,1,2,2,7,0,0,0,0,0
0,0,4,2,2,1,0,0,0,0,3,0,0,3,0,3,0,0,0,3,0,3,0,0,0,0,0,0,0,0
0,0,3,0,0,0,0,1,2,2,7,0,0,3,0,3,0,0,0,6,2,7,0,0,0,0,0,0,0,0
0,0,6,2,2,1,0,3,0,0,0,0,0,3,0,3,0,0,0,0,0,0,0,0,0,0,4,2,2,2
0,0,0,0,0,3,0,3,0,0,0,0,0,3,0,3,0,0,0,9,9,9,0,0,0,0,3,0,0,0
0,0,0,0,0,3,0,3,0,0,0,0,0,3,0,3,0,0,0,0,0,0,0,0,0,0,3,0,0,0
2,2,4,0,0,3,0,3,0,0,4,2,2,1,0,3,0,0,0,4,2,5,0,0,0,0,6,2,2,2
0,0,3,0,0,3,0,3,0,0,3,0,0,0,0,3,0,0,0,3,0,3,0,0,0,0,0,0,0,0
2,2,7,0,0,3,0,3,0,0,6,2,2,2,2,7,0,0,0,3,0,3,0,0,0,0,0,0,0,0
0,0,0,0,0,3,0,3,0,0,0,0,0,0,0,0,0,0,0,3,0,1,2,2,5,0,0,0,0,0
0,0,0,0,0,3,0,3,0,0,0,0,0,0,0,0,0,0,0,3,0,0,0,0,3,0,0,0,0,0
0,0,0,0,0,3,0,3,0,0,0,0,0,0,0,0,0,0,0,1,0,0,0,0,3,0,0,0,0,0