11,00,00,00,07,01,01,01,01,01,01,01,01,01,01,01,01,01,01,01,01,01,01,01,08,00,00,00,00,00
00,00,00,00,07,01,01,01,01,01,01,01,01,01,01,01,01,01,01,01,01,01,01,01,08,00,00,00,00,00
00,00,00,00,07,01,01,01,01,01,01,01,01,01,01,01,01,04,04,04,04,04,01,01,08,00,00,00,00,00
00,00,00,00,07,01,01,01,01,01,01,01,01,01,01,01,12,00,00,00,00,00,11,04,12,00,00,00,00,00
00,00,00,00,07,01,01,01,01,01,01,01,01,01,01,12,00,00,00,00,00,00,00,00,00,00,00,00,00,00
00,00,00,00,07,01,01,01,01,01,01,01,01,01,12,00,00,00,00,00,00,00,00,00,00,00,00,09,05,05
00,00,00,00,07,01,01,01,01,01,01,01,01,12,00,00,00,00,00,00,00,09,05,10,00,00,00,07,01,01
00,00,00,00,11,04,04,04,04,04,04,04,12,00,00,00,00,00,00,00,09,01,01,08,00,00,00,07,01,01
00,00,00,00,02,02,02,02,02,02,02,02,00,00,00,00,00,00,00,09,01,01,01,12,00,00,00,07,01,01
00,00,00,00,02,02,02,02,02,02,02,02,00,00,00,00,00,00,09,01,01,01,12,00,00,00,00,07,01,01
00,00,00,00,02,02,02,02,02,02,02,02,00,00,00,00,00,09,01,01,01,12,00,00,00,00,00,07,01,01
00,00,00,00,09,05,05,05,05,05,05,05,05,05,05,05,05,01,01,01,12,00,00,00,00,00,00,07,01,01
00,00,00,00,11,04,04,04,04,04,04,04,04,01,01,01,01,01,01,12,00,00,00,00,00,00,00,07,01,01
10,00,00,00,00,00,00,00,00,00,00,00,00,11,01,01,01,01,12,00,00,00,00,00,00,00,09,01,01,01
01,10,00,00,00,00,00,00,00,00,00,00,00,00,11,04,04,12,00,00,00,00,00,00,00,09,01,01,01,01
01,01,10,00,00,00,00,00,00,00,00,00,00,00,00,00,00,00,00,00,00,00,00,00,09,01,01,01,01,01
01,01,01,05,05,05,05,05,05,05,05,05,10,00,00,00,00,00,00,00,00,00,00,09,01,01,01,01,01,01
01,01,01,01,01,01,01,01,01,01,01,01,01,10,00,00,00,00,00,00,00,00,09,01,01,01,01,01,01,01
01,01,01,01,01,01,01,01,01,01,01,01,01,01,10,00,00,00,00,00,00,09,01,01,01,01,01,01,01,01

