00,00,00,00,00,00,00,00,00,00,00,00,00,00,00,00,00,00,00,00,00,00,00,00,00,00,00,00,00,00
00,12,00,00,00,00,00,00,00,00,00,07,01,01,01,01,01,01,01,01,01,01,01,01,12,00,00,00,07,00
00,12,00,00,00,00,00,00,00,00,00,07,01,01,01,04,04,04,04,04,04,04,01,01,12,00,00,00,07,00
00,12,00,00,00,00,10,08,00,00,00,11,01,01,12,00,00,00,00,00,00,00,11,01,12,00,00,00,11,00
00,12,00,00,00,00,11,12,00,00,00,00,11,01,12,00,00,00,00,00,00,00,00,11,12,00,00,00,00,00
00,01,08,00,00,00,00,11,08,00,00,00,00,07,12,00,00,00,10,08,00,00,00,00,11,05,08,00,00,00
00,01,01,08,00,00,00,00,07,08,00,00,00,07,12,00,00,00,11,01,08,00,00,00,00,07,12,00,00,00
00,01,01,01,08,00,00,00,07,12,00,00,00,07,12,00,00,00,00,11,01,08,00,00,00,07,12,00,00,00
00,01,01,01,01,08,00,00,07,12,00,00,00,07,01,08,00,00,00,00,11,01,08,00,00,11,09,00,00,00
00,01,01,01,01,12,00,00,07,12,00,00,00,07,01,01,08,00,00,00,00,07,12,00,00,03,03,00,00,00
00,01,01,01,01,09,00,00,07,12,00,00,00,11,01,01,01,08,00,00,00,07,12,00,00,03,03,00,00,00
00,01,01,01,09,00,00,00,07,12,00,00,00,00,11,01,01,01,08,00,00,07,12,00,00,03,03,00,00,00
00,01,01,09,00,00,00,00,07,01,08,00,00,00,00,11,01,01,12,00,00,07,12,00,00,10,08,00,00,00
00,01,09,00,00,00,00,10,01,01,01,08,00,00,00,00,11,01,12,00,00,07,12,00,00,07,12,00,00,00
00,12,00,00,00,00,10,01,01,01,01,01,08,00,00,00,00,11,09,00,00,07,12,00,00,07,12,00,00,00
00,12,00,00,00,10,01,01,01,01,01,01,01,08,00,00,00,00,00,00,00,07,12,00,00,07,12,00,00,00
00,12,00,00,00,07,01,01,01,01,01,01,01,01,08,00,00,00,00,00,00,07,12,00,00,11,09,00,00,00
00,12,00,00,00,07,01,01,01,01,01,01,01,01,01,08,00,00,00,00,00,07,12,00,00,00,00,00,00,00
00,12,00,00,00,07,01,01,01,01,01,01,01,01,01,01,01,01,01,01,01,01,12,00,00,00,00,00,00,00

0,0,0,0,0,0,0,0,0,0,0,0,0,0,0,0,0,0,0,0,0,0,0,0,0,0,0,0,0,0
0,4,0,0,0,0,0,0,0,0,0,4,2,2,2,2,2,2,2,2,2,2,2,2,5,0,0,0,4,0
0,1,0,0,0,0,0,0,0,0,0,3,1,1,1,2,2,2,2,2,2,2,1,1,3,0,0,0,1,0
0,1,0,0,0,0,4,5,0,0,0,6,1,1,3,0,0,0,0,0,0,0,6,1,3,0,0,0,6,0
0,1,0,0,0,0,6,3,0,0,0,0,6,1,3,0,0,0,0,0,0,0,0,6,3,0,0,0,0,0
0,3,5,0,0,0,0,6,5,0,0,0,0,3,3,0,0,0,4,5,0,0,0,0,6,5,0,0,0,0
0,3,1,5,0,0,0,0,3,5,0,0,0,3,3,0,0,0,6,1,5,0,0,0,0,3,5,0,0,0
0,3,1,1,5,0,0,0,3,3,0,0,0,3,3,0,0,0,0,6,1,5,0,0,0,3,3,0,0,0
0,3,1,1,1,5,0,0,3,3,0,0,0,3,1,5,0,0,0,0,6,1,5,0,0,6,7,0,0,0
0,3,1,1,1,3,0,0,3,3,0,0,0,3,1,1,5,0,0,0,0,3,3,0,0,0,0,0,0,0
0,3,1,1,1,7,0,0,3,3,0,0,0,6,1,1,1,5,0,0,0,3,3,0,0,9,9,0,0,0
0,3,1,1,7,0,0,0,3,3,0,0,0,0,6,1,1,1,5,0,0,3,3,0,0,0,0,0,0,0
0,3,1,7,0,0,0,0,3,1,5,0,0,0,0,6,1,1,3,0,0,3,3,0,0,4,5,0,0,0
0,3,7,0,0,0,0,4,1,1,1,5,0,0,0,0,6,1,3,0,0,3,3,0,0,3,3,0,0,0
0,1,0,0,0,0,4,1,1,1,1,1,5,0,0,0,0,6,7,0,0,3,3,0,0,3,3,0,0,0
0,1,0,0,0,4,1,1,1,1,1,1,1,5,0,0,0,0,0,0,0,3,3,0,0,3,3,0,0,0
0,1,0,0,0,3,1,1,1,1,1,1,1,1,5,0,0,0,0,0,0,3,3,0,0,6,7,0,0,0
0,1,0,0,0,3,1,1,1,1,1,1,1,1,1,5,0,0,0,0,0,3,3,0,0,0,0,0,0,0
0,1,0,0,0,3,1,1,1,1,1,1,1,1,1,1,2,2,2,2,2,1,3,0,0,0,0,0,0,0