00,00,00,00,00,00,00,00,00,00,00,00,00,00,00,00,00,00,00,00,00,00,00,00,00,00,00,00,00,00
00,01,01,04,04,04,04,04,04,04,04,04,04,04,04,04,04,04,04,04,04,04,04,04,04,04,04,04,01,00
00,01,12,00,00,00,00,00,00,00,00,00,00,00,00,00,00,00,00,00,00,00,00,00,00,00,00,00,07,00
00,01,12,00,00,00,00,00,00,00,00,00,00,00,00,00,00,00,00,00,00,00,00,00,00,00,00,00,07,00
00,01,12,00,00,00,00,00,00,00,00,00,00,00,00,00,00,00,00,00,00,00,00,00,00,00,00,00,07,00
00,01,12,00,00,00,10,05,05,05,05,05,05,05,05,05,05,05,05,08,02,02,02,10,08,03,03,03,07,00
00,01,12,00,00,00,11,04,04,04,04,04,04,04,04,04,04,04,01,12,02,02,02,11,09,03,03,03,07,00
00,01,12,00,00,00,00,00,00,00,00,00,00,00,00,00,00,00,07,12,00,00,00,00,00,00,00,00,07,00
00,01,09,00,00,00,00,00,00,00,00,00,00,00,00,00,00,00,07,12,00,00,00,00,00,00,00,00,07,00
00,12,00,00,00,00,00,00,00,00,00,00,00,00,00,00,00,00,07,12,03,03,03,10,08,02,02,02,07,00
00,12,00,00,10,05,05,05,05,05,05,05,05,05,08,00,00,00,07,12,03,03,03,11,09,02,02,02,07,00
00,12,00,00,11,04,04,04,04,04,04,04,01,01,12,00,00,00,07,12,00,00,00,00,00,00,00,00,07,00
00,12,00,00,00,00,00,00,00,00,00,00,07,01,12,00,00,00,07,12,00,00,00,00,00,00,00,00,07,00
00,01,08,00,00,00,00,00,00,00,00,00,07,01,12,00,00,00,07,12,02,02,02,10,08,03,03,03,07,00
00,01,12,00,00,00,00,00,00,00,00,00,07,01,12,00,00,00,07,12,02,02,02,07,12,03,03,03,07,00
00,01,12,00,00,00,10,05,08,00,00,00,11,04,09,00,00,00,07,12,00,00,00,11,09,00,00,00,07,00
00,01,12,00,00,00,07,01,12,00,00,00,00,00,00,00,00,00,07,12,00,00,00,00,00,00,00,00,07,00
00,01,12,00,00,00,07,01,12,00,00,00,00,00,00,00,00,00,07,12,00,00,00,00,00,00,00,00,07,00
00,01,12,00,00,00,07,01,12,00,00,00,00,00,00,00,00,00,07,01,05,05,05,08,00,00,00,00,07,00

0,0,0,0,0,0,0,0,0,0,0,0,0,0,0,0,0,0,0,0,0,0,0,0,0,0,0,0,0,0
0,1,1,2,2,2,2,2,2,2,2,2,2,2,2,2,2,2,2,2,2,2,2,2,2,2,2,2,1,0
0,1,3,0,0,0,0,0,0,0,0,0,0,0,0,0,0,0,0,0,0,0,0,0,0,0,0,0,3,0
0,1,3,0,0,0,0,0,0,0,0,0,0,0,0,0,0,0,0,0,0,0,0,0,0,0,0,0,3,0
0,1,3,0,0,0,0,0,0,0,0,0,0,0,0,0,0,0,0,0,0,0,0,0,0,0,0,0,3,0
0,1,3,0,0,0,5,2,2,2,2,2,2,2,2,2,2,2,2,5,0,8,0,4,5,0,9,0,3,0
0,1,3,0,0,0,6,2,2,2,2,2,2,2,2,2,2,2,1,3,0,8,0,6,7,0,9,0,3,0
0,1,3,0,0,0,0,0,0,0,0,0,0,0,0,0,0,0,3,3,0,0,0,0,0,0,0,0,3,0
0,1,7,0,0,0,0,0,0,0,0,0,0,0,0,0,0,0,3,3,0,0,0,0,0,0,0,0,3,0
0,3,0,0,0,0,0,0,0,0,0,0,0,0,0,0,0,0,3,3,0,9,0,4,5,0,8,0,3,0
0,3,0,0,4,2,2,2,2,2,2,2,2,2,5,0,0,0,3,3,0,9,0,6,7,0,8,0,3,0
0,3,0,0,6,2,2,2,2,2,2,2,1,1,3,0,0,0,3,3,0,0,0,0,0,0,0,0,3,0
0,3,0,0,0,0,0,0,0,0,0,0,3,1,3,0,0,0,3,3,0,0,0,0,0,0,0,0,3,0
0,1,5,0,0,0,0,0,0,0,0,0,3,1,3,0,0,0,3,3,0,8,0,4,5,0,9,0,3,0
0,1,3,0,0,0,0,0,0,0,0,0,3,1,3,0,0,0,3,3,0,8,0,3,3,0,9,0,3,0
0,1,3,0,0,0,4,2,5,0,0,0,6,2,7,0,0,0,3,3,0,0,0,6,7,0,0,0,3,0
0,1,3,0,0,0,3,1,3,0,0,0,0,0,0,0,0,0,3,3,0,0,0,0,0,0,0,0,3,0
0,1,3,0,0,0,3,1,3,0,0,0,0,0,0,0,0,0,3,3,0,0,0,0,0,0,0,0,3,0
0,1,3,0,0,0,3,1,3,0,0,0,0,0,0,0,0,0,3,1,2,2,2,5,0,0,0,0,3,0