00,00,00,00,00,00,00,00,00,00,00,00,00,00,00,00,00,00,00,00,00,00,00,00,00,00,00,00,00,00
00,00,10,08,00,00,00,00,00,00,10,08,00,00,00,00,00,00,10,08,00,00,00,00,00,00,10,08,00,00
00,00,11,09,00,00,00,00,00,00,11,09,00,00,00,00,00,00,11,09,00,00,00,00,00,00,11,09,00,00
00,00,00,00,10,08,00,00,10,08,00,00,10,08,00,00,10,08,00,00,10,08,00,00,10,08,00,00,00,00
00,00,00,00,07,12,00,00,11,09,00,00,11,09,00,00,11,09,00,00,11,09,00,00,07,12,00,00,00,00
00,00,00,00,07,12,00,00,00,00,00,00,00,00,00,00,00,00,00,00,00,00,00,00,07,12,00,00,00,00
00,00,00,00,11,09,00,00,00,02,02,02,00,00,00,00,00,00,02,02,02,00,00,00,11,09,00,00,00,00
00,00,10,08,02,02,10,08,00,02,02,02,00,00,00,00,00,00,02,02,02,00,10,08,02,02,10,08,00,00
00,00,11,09,02,02,11,09,00,02,02,02,00,00,00,00,00,00,02,02,02,00,11,09,02,02,11,09,00,00
00,00,00,00,10,08,00,00,00,00,00,00,00,00,10,08,00,00,00,00,00,00,00,00,10,08,00,00,00,00
00,00,00,00,07,12,00,00,00,00,00,00,00,00,11,09,00,00,00,00,00,00,00,00,07,12,00,00,00,00
00,00,00,00,07,12,00,00,10,08,00,00,10,08,03,03,10,08,00,00,10,08,00,00,07,12,00,00,00,00
00,00,00,00,11,09,00,00,11,09,00,00,11,09,03,03,11,09,00,00,11,09,00,00,11,09,00,00,00,00
00,00,00,00,00,00,00,00,00,00,00,00,00,00,10,08,00,00,00,00,00,00,00,00,00,00,00,00,00,00
00,00,00,00,00,00,00,00,00,00,00,00,00,00,11,09,00,00,00,00,00,00,00,00,00,00,00,00,00,00
00,10,08,00,00,00,10,08,00,00,00,00,00,00,00,00,00,00,00,00,00,00,10,08,00,00,00,10,08,00
00,07,12,00,00,00,11,09,00,00,00,00,00,00,00,00,00,00,00,00,00,00,11,09,00,00,00,07,12,00
00,07,12,00,00,00,00,00,10,05,05,05,05,05,05,05,05,05,05,05,05,08,00,00,00,00,00,07,12,00
00,07,12,00,00,00,00,00,07,01,01,01,01,01,01,01,01,01,01,01,01,12,00,00,00,00,00,07,12,00

0,0,0,0,0,0,0,0,0,0,0,0,0,0,0,0,0,0,0,0,0,0,0,0,0,0,0,0,0,0
0,0,4,5,0,0,0,0,0,0,4,5,0,0,0,0,0,0,4,5,0,0,0,0,0,0,4,5,0,0
0,0,6,7,0,0,0,0,0,0,6,7,0,0,0,0,0,0,6,7,0,0,0,0,0,0,6,7,0,0
0,0,0,0,4,5,0,0,4,5,0,0,4,5,0,0,4,5,0,0,4,5,0,0,4,5,0,0,0,0
0,0,0,0,3,3,0,0,6,7,0,0,6,7,0,0,6,7,0,0,6,7,0,0,3,3,0,0,0,0
0,0,0,0,3,3,0,0,0,0,0,0,0,0,0,0,0,0,0,0,0,0,0,0,3,3,0,0,0,0
0,0,0,0,6,7,0,0,0,8,8,8,0,0,0,0,0,0,8,8,8,0,0,0,6,7,0,0,0,0
0,0,4,5,0,0,4,5,0,8,8,8,0,0,0,0,0,0,8,8,8,0,4,5,0,0,4,5,0,0
0,0,6,7,0,0,6,7,0,8,8,8,0,0,0,0,0,0,8,8,8,0,6,7,0,0,6,7,0,0
0,0,0,0,4,5,0,0,0,0,0,0,0,0,4,5,0,0,0,0,0,0,0,0,4,5,0,0,0,0
0,0,0,0,3,3,0,0,0,0,0,0,0,0,6,7,0,0,0,0,0,0,0,0,3,3,0,0,0,0
0,0,0,0,3,3,0,0,4,5,0,0,4,5,0,0,4,5,0,0,4,5,0,0,3,3,0,0,0,0
0,0,0,0,6,7,0,0,6,7,0,0,6,7,0,0,6,7,0,0,6,7,0,0,6,7,0,0,0,0
0,0,0,0,0,0,0,0,0,0,0,0,0,0,4,5,0,0,0,0,0,0,0,0,0,0,0,0,0,0
0,0,0,0,0,0,0,0,0,0,0,0,0,0,6,7,0,0,0,0,0,0,0,0,0,0,0,0,0,0
0,4,5,0,0,0,4,5,0,0,0,0,0,0,0,0,0,0,0,0,0,0,4,5,0,0,0,4,5,0
0,3,3,0,0,0,6,6,0,0,0,0,0,0,0,0,0,0,0,0,0,0,6,7,0,0,0,3,3,0
0,3,3,0,0,0,0,0,4,2,2,2,2,2,2,2,2,2,2,2,2,6,0,0,0,0,0,3,3,0
0,3,3,0,0,0,0,0,1,1,1,1,1,1,1,1,1,1,1,1,1,1,0,0,0,0,0,3,3,0