00,00,00,00,00,00,00,00,00,00,00,00,00,00,00,00,00,00,00,00,00,00,00,00,00,00,00,00,00,00
00,00,00,00,00,00,00,00,00,00,00,00,00,00,00,10,05,05,08,00,00,00,00,00,00,00,00,00,00,00
00,00,00,00,00,00,00,00,00,00,00,00,00,00,00,07,01,01,12,00,00,00,00,00,00,00,00,00,00,00
00,00,00,10,05,05,05,05,05,05,08,00,00,00,00,07,01,04,09,00,00,10,05,08,00,00,00,00,00,00
00,00,00,07,01,01,04,04,04,04,09,00,00,00,00,07,12,00,00,00,00,07,01,12,00,02,00,00,02,00
00,00,00,07,01,09,03,03,03,03,03,03,00,00,10,01,12,00,00,00,00,07,01,12,00,00,00,00,00,00
00,00,00,07,12,03,03,03,03,03,03,03,03,10,01,01,12,00,00,10,05,01,01,12,00,00,02,02,00,00
00,00,00,07,12,03,03,03,03,03,03,03,03,11,01,01,12,00,00,11,04,01,01,12,00,00,00,00,00,00
00,00,00,07,01,08,03,03,03,03,03,03,00,00,11,01,12,00,00,00,00,07,01,12,00,02,00,00,02,00
00,00,00,07,01,01,05,05,05,05,08,00,00,00,00,07,12,00,00,00,00,07,01,12,00,00,00,00,00,00
00,00,00,11,04,04,04,04,04,04,04,08,00,00,00,07,01,05,08,00,00,07,01,12,00,00,02,02,00,00
00,00,00,00,00,00,00,00,00,00,00,07,08,00,00,07,01,04,09,00,00,07,01,12,00,00,00,00,00,00
00,00,00,00,00,00,00,00,00,00,00,07,12,00,00,07,12,03,03,03,00,07,01,12,00,02,00,00,02,00
00,10,05,05,05,05,05,05,08,00,00,07,12,00,00,07,12,03,03,03,10,01,01,12,00,00,00,00,00,00
00,07,01,04,04,04,04,01,12,00,00,07,12,00,00,07,12,03,03,03,07,01,01,12,00,00,02,02,00,00
00,07,12,00,00,00,00,07,12,00,00,07,12,00,00,07,12,00,00,00,07,01,01,09,00,00,00,00,00,00
00,07,12,00,00,00,00,11,09,00,00,07,12,00,00,11,09,00,00,00,07,01,12,00,00,00,00,00,00,00
00,07,12,00,00,00,00,00,00,00,00,07,12,00,00,00,00,00,00,00,07,01,12,00,00,00,00,10,08,00
00,07,12,00,00,00,00,00,00,00,00,07,12,00,00,00,00,00,00,00,07,01,12,00,00,00,00,07,12,00

0,0,0,0,0,0,0,0,0,0,0,0,0,0,0,0,0,0,0,0,0,0,0,0,0,0,0,0,0,0
0,0,0,0,0,0,0,0,0,0,0,0,0,0,0,4,2,2,5,0,0,0,0,0,0,0,0,0,0,0
0,0,0,0,0,0,0,0,0,0,0,0,0,0,0,3,1,1,3,0,0,0,0,0,0,0,0,0,0,0
0,0,0,4,1,2,2,2,2,2,5,0,0,0,0,3,1,2,7,0,0,4,2,5,0,0,0,0,0,0
0,0,0,1,0,3,2,2,2,2,7,0,0,0,0,3,3,0,0,0,0,3,1,3,0,8,0,0,8,0
0,0,0,3,2,7,0,0,0,0,0,0,0,0,4,1,3,0,0,0,0,3,1,3,0,0,0,0,0,0
0,0,0,3,3,0,9,9,9,9,9,9,0,4,1,1,3,0,0,4,2,1,1,3,0,0,8,8,0,0
0,0,0,3,3,0,9,9,9,9,9,9,0,6,1,1,3,0,0,6,2,1,1,3,0,0,0,0,0,0
0,0,0,3,2,5,0,0,0,0,0,0,0,0,6,1,3,0,0,0,0,3,1,3,0,8,0,0,8,0
0,0,0,1,0,3,2,2,2,2,5,0,0,0,0,3,3,0,0,0,0,3,1,3,0,0,0,0,0,0
0,0,0,6,1,2,2,2,2,2,2,5,0,0,0,3,1,2,5,0,0,3,1,3,0,0,8,8,0,0
0,0,0,0,0,0,0,0,0,0,0,3,5,0,0,3,1,2,7,0,0,3,1,3,0,0,0,0,0,0
0,0,0,0,0,0,0,0,0,0,0,3,3,0,0,3,3,0,0,0,0,3,1,3,0,8,0,0,8,0
0,4,2,2,2,2,2,2,5,0,0,3,3,0,0,3,3,0,9,0,4,1,1,3,0,0,0,0,0,0
0,3,1,2,2,2,2,1,3,0,0,3,3,0,0,3,3,0,9,0,3,1,1,3,0,0,8,8,0,0
0,3,3,0,0,0,0,3,3,0,0,3,3,0,0,3,3,0,0,0,3,1,1,7,0,0,0,0,0,0
0,3,3,0,0,0,0,6,7,0,0,3,3,0,0,6,7,0,0,0,3,1,3,0,0,0,0,0,0,0
0,3,3,0,0,0,0,0,0,0,0,3,3,0,0,0,0,0,0,0,3,1,3,0,0,0,0,4,5,0
0,3,3,0,0,0,0,0,0,0,0,3,3,0,0,0,0,0,0,0,3,1,3,0,0,0,0,3,3,0