00,00,00,00,00,00,00,00,00,00,00,00,00,00,00,00,00,00,00,00,00,00,00,00,00,00,00,00,00,00
00,01,01,01,01,01,01,01,01,01,01,01,01,01,01,01,01,01,01,01,01,01,01,01,12,00,00,00,07,00
00,01,01,01,01,01,01,01,01,01,01,01,01,01,01,01,01,01,01,01,01,01,01,01,12,00,00,00,07,00
00,01,01,01,01,01,01,01,01,01,01,01,01,01,01,01,01,01,01,01,01,01,01,01,12,00,00,00,07,00
00,01,01,01,01,01,01,01,01,01,01,01,01,01,01,01,01,01,01,01,01,01,01,01,12,00,00,00,07,00
00,01,01,01,01,01,01,01,01,01,01,01,01,01,01,01,01,01,01,01,01,01,01,01,12,00,00,00,07,00
00,01,01,01,01,01,01,01,01,01,01,01,01,01,01,01,01,01,01,01,01,01,01,01,12,00,00,00,07,00
00,01,01,01,01,04,04,01,01,01,01,01,01,01,01,01,01,01,01,04,04,04,04,04,09,02,02,02,07,00
00,01,01,01,09,03,03,11,01,01,01,01,01,04,04,04,04,04,09,00,00,00,00,00,00,02,02,02,07,00
00,01,04,09,00,03,03,00,11,04,04,04,09,00,00,00,03,03,03,00,00,00,00,00,00,02,02,02,07,00
00,12,00,00,00,03,03,00,00,00,03,03,03,00,00,00,03,03,03,00,10,05,05,05,05,05,05,05,01,00
00,12,00,00,00,10,08,00,00,00,03,03,03,00,10,08,03,03,03,10,01,01,01,01,01,01,01,01,01,00
00,12,00,00,00,07,01,05,05,08,03,03,03,10,01,01,05,05,05,01,01,01,01,01,01,01,01,01,01,00
00,12,00,00,00,07,01,01,01,01,05,05,05,01,01,01,01,01,01,01,01,01,01,01,01,01,01,01,01,00
00,12,00,00,00,07,01,01,01,01,01,01,01,01,01,01,01,01,01,01,01,01,01,01,01,01,01,01,01,00
00,12,00,00,00,07,01,01,01,01,01,01,01,01,01,01,01,01,01,01,01,01,01,01,01,01,01,01,01,00
00,12,00,00,00,07,01,01,01,01,01,01,01,01,01,01,01,01,01,01,01,01,01,01,01,01,01,01,01,00
00,12,00,00,00,07,01,01,01,01,01,01,01,01,01,01,01,01,01,01,01,01,01,01,01,01,01,01,01,00
00,12,00,00,00,07,01,01,01,01,01,01,01,01,01,01,01,01,01,01,01,01,01,01,01,01,01,01,01,00

0,0,0,0,0,0,0,0,0,0,0,0,0,0,0,0,0,0,0,0,0,0,0,0,0,0,0,0,0,0
0,0,0,0,0,0,0,0,0,0,0,0,0,0,0,0,0,0,0,0,0,0,0,0,4,0,0,0,4,0
0,0,0,0,0,0,0,0,0,0,0,0,0,0,0,0,0,0,0,0,0,0,0,0,1,0,0,0,1,0
0,0,0,0,0,0,0,0,0,0,0,0,0,0,0,0,0,0,0,0,0,0,0,0,1,0,0,0,1,0
0,0,0,0,0,0,0,0,0,0,0,0,0,0,0,0,0,0,0,0,0,0,0,0,1,0,0,0,1,0
0,0,0,0,0,0,0,0,0,0,0,0,0,0,0,0,0,0,0,0,0,0,0,0,1,0,0,0,1,0
0,0,0,0,0,0,0,0,0,0,0,0,0,0,0,0,0,0,0,0,0,0,0,0,1,0,0,0,1,0
0,0,0,0,4,1,1,5,0,0,0,0,0,0,0,0,0,0,4,1,1,1,1,1,7,0,0,0,1,0
0,0,0,4,7,0,0,6,5,0,0,0,4,1,1,1,1,1,7,0,0,0,0,0,0,8,8,0,1,0
0,4,1,7,0,9,9,0,6,1,1,1,7,0,0,0,0,0,0,0,0,0,0,0,0,0,0,0,1,0
0,1,0,0,0,0,0,0,0,0,0,0,0,0,0,0,9,9,9,0,4,1,1,1,1,1,1,1,7,0
0,1,0,0,0,4,5,0,0,0,9,9,9,0,4,5,0,0,0,4,7,0,0,0,0,0,0,0,0,0
0,1,0,0,0,3,2,1,1,5,0,0,0,4,2,2,1,1,1,7,0,0,0,0,0,0,0,0,0,0
0,1,0,0,0,1,0,0,0,6,1,1,1,7,0,0,0,0,0,0,0,0,0,0,0,0,0,0,0,0
0,1,0,0,0,1,0,0,0,0,0,0,0,0,0,0,0,0,0,0,0,0,0,0,0,0,0,0,0,0
0,1,0,0,0,1,0,0,0,0,0,0,0,0,0,0,0,0,0,0,0,0,0,0,0,0,0,0,0,0
0,1,0,0,0,1,0,0,0,0,0,0,0,0,0,0,0,0,0,0,0,0,0,0,0,0,0,0,0,0
0,1,0,0,0,1,0,0,0,0,0,0,0,0,0,0,0,0,0,0,0,0,0,0,0,0,0,0,0,0
0,1,0,0,0,1,0,0,0,0,0,0,0,0,0,0,0,0,0,0,0,0,0,0,0,0,0,0,0,0